+---+---+---+---+---+---+---+---+---+---+
|                       |               |
+   +---+   +---+---+   +   +---+---+   +
|   |           |       |   |           |
+---+   +---+   +---+   +   +   +---+---+
|   |   |       |   |   |   |           |
+   +---+---+   +   +   +   +---+---+   +
|   |   |       |       |   |       |   |
+   +   +---+   +   +---+   +   +   +   +
|       |       |           |   |       |
+   +   +   +---+---+---+---+---+---+---+
|   |       |           |   |           |
+   +---+---+   +---+---+   +   +---+---+
|   |       |   |                       |
+   +   +---+   +   +---+---+---+---+---+
|           |                           |
+---+   +---+   +   +---+   +   +---+   +
|   |           |   |   |   |       |   |
+   +   +---+---+---+   +---+   +---+   +
|       |                           |   |
+---+---+---+---+---+---+---+---+---+---+
